###############
#.............#
#.............#
#.............#
#........#....#
#......@......#
#.............#
#.........#...#
#.............#
#...#.........#
#........#....#
#.............#
###############


---------------------------------- // Delimiter levels
---------------------------------- // Option 1 


###############
#.............#
#....#........#
#.............#
#.....#.......#
#....#@#......#
#.....#.......#
#.............#
#.............#
#.......#.....#
#.............#
#.............#
###############


---------------------------------- // Option 2


###############
#@............#
#.###########.#
#.............# 
#.............#
#.............#
#....#........#
#.............#
#........#....#
#.............#
#.............#
#.....#.......#
###############


---------------------------------- // Option 3

###############
#.............#
#.............#
#.............#
#.............#
#.............#
#......#......#
#.............#
##.#.##@##..#.#
#.............#
#......#......#
#.............#
###############


---------------------------------- // Common level

###############
#.............#
#.............#
#.............#
#.............#
#.............#
#.............#
#.............#
#.............#
#.............#
#.............#
#.............#
###############