######ddd######
#F...........F#
#.............#
#....#####....#
#.............#
#..#.......#..#
d..#..EEE..#..d
d..#..EEE..#..d
d..#..EEE..#..d
#..#.......#..#
#.............#
#...######....#
#.............#
#F...........F#
######ddd######