######ddd######
#.............#
#......E......#
#.............#
#.............#
#.............#
d.............d
d.............d
d.............d
#.............#
#.............#
#.............#
#.............#
#.............#
######ddd######