######ddd######
#.EE.......EE.#
#E###.....###E#
#E#F#.....#F#E#
#.###.....###.#
#....E...E....#
d.....E.E.....d
d......E......d
d.....E.E.....d
#....E...E....#
#.###.....###.#
#E#F#.....#F#E#
#E###.....###E#
#.EE.......EE.#
######ddd######