######ddd######
#F...........F#
#.............#
#....#####....#
#.....EFE.....#
#..#...E...#..#
d..#E.E.E.E#..d
d..#FE...EF#..d
d..#E.E.E.E#..d
#..#...E...#..#
#.....EFE.....#
#....#####....#
#.............#
#F...........F#
######ddd######