######ddd######
##...........##
#.............#
#.............#
#.............#
#.............#
d.....EEE.....d
d.....EEE.....d
d.....EEE.....d
#.............#
#.............#
#.............#
#.............#
##...........##
######ddd######