######ddd######
#EE.........EE#
#EE.........EE#
#.............#
#.............#
#....F#E#F....#
d....#EEE#....d
d....EEEEE....d
d....#EEE#....d
#....F#E#F....#
#.............#
#.............#
#EE.........EE#
#EE.........EE#
######ddd######