#####ddd#####
#...........#
#...........#
d...........d
d...........d
d...........d
#...........#
#...........#
#####ddd#####