######ddd######
#.............#
#.###.....###.#
#.#F#.....#F#.#
#.###.....###.#
#.............#
d.............d
d.............d
d.............d
#.............#
#.###.....###.#
#.#F#.....#F#.#
#.###.....###.#
#.............#
######ddd######